######################
# Rerum Novarum TAGs #
######################

# Custom Tags

KFR = "countries/French Kingdom.txt"
SPU = "countries/Spanish African Union.txt"
SWU = "countries/Spanish West Indies.txt"
OKL = "countries/Oklahoma.txt"
PAP = "countries/Papal States.txt"
MUS = "countries/Muscovy.txt"
MID = "countries/Midwest FederaL States.txt"
CAL = "countries/California.txt"
SIB = "countries/Siberia.txt"
DEL = "countries/Delhi.txt"
NAP = "countries/Naples.txt"
MUG = "countries/Mughals.txt"
EPR = "countries/East Prussia.txt"
GRJ = "countries/German Raj.txt"
HBC = "countries/Hudson Bay Company.txt"
ENX = "countries/British Government in Exile.txt"
SAR = "countries/Special Administrative Region.txt"
#CHB = "countries/Chaco Boreal.txt"
UCY = "countries/Ucayali Republic.txt"
SCR = "countries/Santa Cruz Republic.txt"
BCL = "countries/New Columbia.txt"
UCA = "countries/United Central America.txt"
ONT = "countries/Ontario.txt"
#UYG = "countries/Uyghurstan.txt"
#ITA = "countries/Italy.txt"

# Vanilla Tags

RUS = "countries/Russia.txt"
#CAR = "countries/Central African Republic.txt"
#PER = "countries/Persian Empire.txt"
#BLR = "countries/White Russia.txt"
#MAN = "countries/Manchuria.txt"
#POR = "countries/Portugal.txt"
